$ANSIBLE_VAULT;1.1;AES256
35643932383435626233353937326432623765353364393939313466316337663764626339373966
6637346638383961666235333733333665363435343630650a646634323232613038313866656133
38626633666533663733323266326361336439326339333039353736363232616563363033346539
6464356163323931350a326538663937613232663835333633643531303361613538336663326431
34313030353037366232343165383731316661343131356663316431383930653564386664643063
39303965666638396263303166613034616164643533323463356335646138633161393436333765
62363161376134636363306437366436396530623936346461346534343733316561626634313637
65313338383633643261383861323138623337646163363136346364363236646236376264393233
34613635626437346435383166326632656561313134633030356535636465303665376531653833
64346437313666633963626565343766316432336661363936626537353263623032656261613431
63383965656561383237383961373462613530613962613165343736396530666539313837633038
64643732373934333134303065633031626633393038373231656332393237353862623664613834
32343032626163326261663132326564373033313338333631366639633363353332623630316232
38643661333931323532313336343336346632386262616439646166633039346366323136663535
39366534643836313732396531623537393638643636353464663337363363333234336137393439
63353033343365326630393537356134363737353365613830366336613465376235633365656366
61393161613761623465666166623338666232613063613835653838356466333139373034376439
35353638643238386530396636363362323865383637316636323032303361636632623430633030
63326465633762323964633566313932303230666136623137303232366164326662363735633132
37363263393134303131643163356461363265626366393630656339303632323465336434643162
66383266343739636536656534383337326433613637656338353964626137633366643064366538
63623862633832393433313733353635633766666563313962663066393332623132363439626634
39393735653330366238363963336465623565313565373364613538666530343937316464333636
61643430373930343439313331326439316531663636363332323334383734366165343961346532
65323962616130336564393133613937623630616633656662343132363966373465313738613763
38376237323532346363393835353432366434353738633538393836633865346162386237323135
32616531636261326532316664303330363638656638326630633263396630643736386661323630
37633037356664333236306535343466346664356437363630373835636136366534663864326561
61393866613930323762353831396661623336386164333036323632346364626436353866386232
63383764373836363430363036396364623937653632353632643735353764383264393661666233
63356235326531616538316336346437323662326363393164623365393630373339343566653466
33623639613838343164653330313362356562383364333331366162393765343335653735646332
61363863613835613931376136383030653163323663666339326636613935616439623335336462
66666431636263306332323334303333323335336232613461363632663165346534626131663161
36323230366363343535616261666361303332643863636634646633396137376665313936306131
39626366336435613638626532336331383135303736643561666566336335373730633064306366
30643935353935346237353866316362326563613262663936643339373034366363633639633966
39613334656131363433613838366239363065396661323030313336333431663034636531356638
38366233666234333838656562346433643438333464613131656663396139306332383961663763
31383534326363636633383632396365363937633037346661323336313162363362316461376134
66376638343330383064653162623061633033363263366231393434323734663830393735346635
32353265656239656238656433326531396533396631336532653766313766386436386231326237
63646238326362356135313535643931393736663732386337393736336332306331363336353765
37666336643063646264353231346365313861333466363539333864393733653933343930636334
64653435376438356261643831383765613936663633323235616236623930656361383837363731
34323736626236386566323065626132633563663462626636376335303130366566616263306130
37316237333363323965393539653535643739613438626462366163366363303235666435653964
34323036333236663837643531303462363730383363636632643063323963616466393263393632
34616262313735663237303065346132663133333361363233333138613437633965666539626533
36376332316565616565346633316231653736643934663431353537356237336330323534616561
35643263393763333634386466663032613464643561376133366430616439386561356165383230
33613637336138363735
